skill_code	skill_name	camp_code	disp_order
VILLAGER	村人	VILLAGER	1
WEREWOLF	人狼	WEREWOLF	2
SEER	占い師	VILLAGER	3
MEDIUM	霊能者	VILLAGER	4
MADMAN	狂人	WEREWOLF	5
HUNTER	狩人	VILLAGER	6
MASON	共鳴者	VILLAGER	7
WISE	賢者	VILLAGER	8
GURU	導師	VILLAGER	9
CMADMAN	C国狂人	WEREWOLF	10
EVILMEDIUM	魔神官	WEREWOLF	11
FANATIC	狂信者	WEREWOLF	12
FOX	妖狐	FOX	13
LEFTOVER	おまかせ	VILLAGER	14
VILLAGERS	おまかせ（村人陣営）	VILLAGER	15
WEREWOLFS	おまかせ（人狼陣営）	VILLAGER	16
NOVILLAGERS	おまかせ（人外）	VILLAGER	17
FOOTSTEPS	おまかせ（足音職）	VILLAGER	18
FRIENDS	おまかせ（役職窓あり）	VILLAGER	19