ability_type_code	ability_type_name
ATTACK	襲撃
DIVINE	占い
GUARD	護衛
WANDERERGUARD	風来護衛
INVESTIGATE	捜査
TRAP	罠設置
BOMB	爆弾設置
COHABIT	同棲
COMMAND	指揮
FRUITSBASKET	フルーツバスケット
COURT	求愛
STALKING	ストーキング
CHEAT	誑かす
LONEATTACK	単独襲撃
SEDUCE	誘惑
BADGERGAME	美人局
WALLPUNCH	壁殴り
INSTIGATE	煽動
RAINBOW	虹塗り
LOUDSPEAK	拡声
FORCE_REINCARNATION	強制転生
RESUSCITATE	蘇生
NECROMANCE	死霊蘇生